NC - Noun Common
PU - Punctuation	
VM - Verb-finite
JJ - Adjective
NP - Noun Proper
JQ - NOMINAL MODIFIER Quantifier
PPR - Pronoun Pronominal
PP - Postposition
CCD - Particle Coordinating
NV - Noun Verbal
CX - Particle Others
VAUX - Verb Aux
DAB - DEMONSTRATIVE Absolute
NST - Noun Spatio-temporal
CSB - Particle Subordinating
ALC - Adverb Location
AMN - Adverb Manner
RDS - RESIDUAL Symbol
RDF - RESIDUAL Foreign word
LC - Participle Conditional
VA - Verb Auxiliary
PRL - Pronoun Relative
RDX - RESIDUAL Others
PWH - Pronoun Wh-pronoun
CCL - Particle Classifier
DRL - Demonstrative Relative
PRF - Pronoun Reflexive
CIN - Particle Interjection
LV - Participle Verbal (Adverbial)	
DWH - DEMONSTRATIVE Wh
PRC - Pronoun Reciprocal
?
;
CSD - Participle Subordinating and Coordinating
NCgen - Noun Common Genereal
PU1985 - Punctuation unknown